NO ./texture/wall.xpm
SO ./texture/wall.xpm
WE ./texture/wall.xpm
EA ./texture/wall.xpm

F 54,100,125
C 100,60,125

111111111111111111111111
100000000100000000000001   
100000000100000000000001
100000000100000000000001
100000000100000000000001
100000000100000000000001
100000000111101100000001
100000000000000100000001
100000000000000100000001
111111111111111111111111
100010000000100000000001
100010000000100000000001
100010000000100000000001
111110000000100000000001
100000000000100000000001
100000000000100000000001
100000000000100000000001
100000000000100000000001
111111111111111111111111
